1111111111111
100100000E0C1
1000011111001
100011E00P001
1111111111111