1111111111111
10010000000C1
1000011100001
1P0011E000001
111111111111