111111 1111111
100100 00000C1
100001 1111001
1P0011 E000001
111111 1111111