111111111111111111
100000001000C00001
100000001000000001
1000P0001000000001
1000E0001000000001
111111111111111111