111111111111111111
100000001000E00001
100000001000000001
1000P0001000000001
1000C0001000000001
111111111111111111