1111111111111
10010000C0CC1
1000011111001
1000011111001
1000011111001
1000011111001
1000011111001
1000011111001
10010000C0CC1
10010000C0CC1
11010000C0CC1
1P1111E100001
1111111111111