1111111111111111
10000000E0001CC1
10110C00000X0001
1011000000000011
1P0C010110010001
1000000000000001
10000C0100000001
1000000000C10001
1111111111111111